,year,state,county_fips,county_name,democrat_votes,republican_votes,total_votes,population
0,2000,VIRGINIA,51001,ACCOMACK,5092,6352,11444,38305.0
1,2000,VIRGINIA,51003,ALBEMARLE,16255,18291,34546,79236.0
2,2000,VIRGINIA,51005,ALLEGHANY,2214,2808,5022,12926.0
3,2000,VIRGINIA,51007,AMELIA,1754,2947,4701,11400.0
4,2000,VIRGINIA,51009,AMHERST,4812,6660,11472,31894.0
5,2000,VIRGINIA,51011,APPOMATTOX,2132,3654,5786,13705.0
6,2000,VIRGINIA,51013,ARLINGTON,50260,28555,78815,189453.0
7,2000,VIRGINIA,51015,AUGUSTA,6643,17744,24387,65615.0
8,2000,VIRGINIA,51017,BATH,822,1311,2133,5048.0
9,2000,VIRGINIA,51019,BEDFORD,8160,17224,25384,60371.0
10,2000,VIRGINIA,51021,BLAND,851,1759,2610,6871.0
11,2000,VIRGINIA,51023,BOTETOURT,4627,8867,13494,30496.0
12,2000,VIRGINIA,51025,BRUNSWICK,3387,2561,5948,18419.0
13,2000,VIRGINIA,51027,BUCHANAN,5745,3867,9612,26978.0
14,2000,VIRGINIA,51029,BUCKINGHAM,2561,2738,5299,15623.0
15,2000,VIRGINIA,51031,CAMPBELL,6659,13162,19821,51078.0
16,2000,VIRGINIA,51033,CAROLINE,4314,3873,8187,22121.0
17,2000,VIRGINIA,51035,CARROLL,3638,7142,10780,29245.0
18,2000,VIRGINIA,51036,CHARLES CITY,1981,1023,3004,6926.0
19,2000,VIRGINIA,51037,CHARLOTTE,2017,2855,4872,12472.0
20,2000,VIRGINIA,51041,CHESTERFIELD,38638,69924,108562,259903.0
21,2000,VIRGINIA,51043,CLARKE,2166,2883,5049,12652.0
22,2000,VIRGINIA,51045,CRAIG,851,1580,2431,5091.0
23,2000,VIRGINIA,51047,CULPEPER,4364,7440,11804,34262.0
24,2000,VIRGINIA,51049,CUMBERLAND,1405,1974,3379,9017.0
25,2000,VIRGINIA,51051,DICKENSON,3951,3122,7073,16395.0
26,2000,VIRGINIA,51053,DINWIDDIE,4001,4959,8960,24533.0
27,2000,VIRGINIA,51057,ESSEX,1750,1995,3745,9989.0
28,2000,VIRGINIA,51059,FAIRFAX,196501,202181,398682,969749.0
29,2000,VIRGINIA,51061,FAUQUIER,8296,14456,22752,55139.0
30,2000,VIRGINIA,51063,FLOYD,1957,3423,5380,13874.0
31,2000,VIRGINIA,51065,FLUVANNA,3431,4962,8393,20047.0
32,2000,VIRGINIA,51067,FRANKLIN,7145,11225,18370,47286.0
33,2000,VIRGINIA,51069,FREDERICK,7158,14574,21732,59209.0
34,2000,VIRGINIA,51071,GILES,3004,3574,6578,16657.0
35,2000,VIRGINIA,51073,GLOUCESTER,4553,8718,13271,34780.0
36,2000,VIRGINIA,51075,GOOCHLAND,3197,5378,8575,16863.0
37,2000,VIRGINIA,51077,GRAYSON,2467,4236,6703,17917.0
38,2000,VIRGINIA,51079,GREENE,1774,3375,5149,15244.0
39,2000,VIRGINIA,51081,GREENSVILLE,2314,1565,3879,11560.0
40,2000,VIRGINIA,51083,HALIFAX,5963,7732,13695,37355.0
41,2000,VIRGINIA,51085,HANOVER,12044,28614,40658,86320.0
42,2000,VIRGINIA,51087,HENRICO,48645,62887,111532,262300.0
43,2000,VIRGINIA,51089,HENRY,8898,11870,20768,57930.0
44,2000,VIRGINIA,51091,HIGHLAND,453,942,1395,2536.0
45,2000,VIRGINIA,51093,ISLE OF WIGHT,5162,7587,12749,29728.0
46,2000,VIRGINIA,51095,JAMES CITY,9090,14628,23718,48102.0
47,2000,VIRGINIA,51097,KING AND QUEEN,1387,1423,2810,6630.0
48,2000,VIRGINIA,51099,KING GEORGE,2070,3590,5660,16803.0
49,2000,VIRGINIA,51101,KING WILLIAM,2125,3547,5672,13146.0
50,2000,VIRGINIA,51103,LANCASTER,1937,3411,5348,11567.0
51,2000,VIRGINIA,51105,LEE,4031,4551,8582,23589.0
52,2000,VIRGINIA,51107,LOUDOUN,30938,42453,73391,169599.0
53,2000,VIRGINIA,51109,LOUISA,4309,5461,9770,25627.0
54,2000,VIRGINIA,51111,LUNENBURG,2026,2510,4536,13146.0
55,2000,VIRGINIA,51113,MADISON,1844,2940,4784,12520.0
56,2000,VIRGINIA,51115,MATHEWS,1499,2951,4450,9207.0
57,2000,VIRGINIA,51117,MECKLENBURG,4797,6600,11397,32380.0
58,2000,VIRGINIA,51119,MIDDLESEX,1671,2844,4515,9932.0
59,2000,VIRGINIA,51121,MONTGOMERY,11720,13991,25711,83629.0
60,2000,VIRGINIA,51125,NELSON,2907,2913,5820,14445.0
61,2000,VIRGINIA,51127,NEW KENT,2055,3934,5989,13462.0
62,2000,VIRGINIA,51131,NORTHAMPTON,2340,2299,4639,13093.0
63,2000,VIRGINIA,51133,NORTHUMBERLAND,2118,3362,5480,12259.0
64,2000,VIRGINIA,51135,NOTTOWAY,2460,2870,5330,15725.0
65,2000,VIRGINIA,51137,ORANGE,4126,5991,10117,25881.0
66,2000,VIRGINIA,51139,PAGE,2726,5089,7815,23177.0
67,2000,VIRGINIA,51141,PATRICK,2254,4901,7155,19407.0
68,2000,VIRGINIA,51143,PITTSYLVANIA,7834,15760,23594,61745.0
69,2000,VIRGINIA,51145,POWHATAN,2708,6820,9528,22377.0
70,2000,VIRGINIA,51147,PRINCE EDWARD,2922,3214,6136,19720.0
71,2000,VIRGINIA,51149,PRINCE GEORGE,4182,6579,10761,33047.0
72,2000,VIRGINIA,51153,PRINCE WILLIAM,44745,52788,97533,280813.0
73,2000,VIRGINIA,51155,PULASKI,5255,7089,12344,35127.0
74,2000,VIRGINIA,51157,RAPPAHANNOCK,1462,1850,3312,6983.0
75,2000,VIRGINIA,51159,RICHMOND,1076,1784,2860,8809.0
76,2000,VIRGINIA,51161,ROANOKE,16141,25740,41881,85778.0
77,2000,VIRGINIA,51163,ROCKBRIDGE,2953,4522,7475,20808.0
78,2000,VIRGINIA,51165,ROCKINGHAM,5834,17482,23316,67725.0
79,2000,VIRGINIA,51167,RUSSELL,5442,5065,10507,30308.0
80,2000,VIRGINIA,51169,SCOTT,3552,5535,9087,23403.0
81,2000,VIRGINIA,51171,SHENANDOAH,4420,9636,14056,35075.0
82,2000,VIRGINIA,51173,SMYTH,4836,6580,11416,33081.0
83,2000,VIRGINIA,51175,SOUTHAMPTON,3359,3293,6652,17482.0
84,2000,VIRGINIA,51177,SPOTSYLVANIA,13455,20739,34194,90395.0
85,2000,VIRGINIA,51179,STAFFORD,12596,20731,33327,92446.0
86,2000,VIRGINIA,51181,SURRY,1845,1313,3158,6829.0
87,2000,VIRGINIA,51183,SUSSEX,2006,1745,3751,12504.0
88,2000,VIRGINIA,51185,TAZEWELL,7227,8655,15882,44598.0
89,2000,VIRGINIA,51187,WARREN,4313,6335,10648,31584.0
90,2000,VIRGINIA,51191,WASHINGTON,7549,12064,19613,51103.0
91,2000,VIRGINIA,51193,WESTMORELAND,2922,2932,5854,16718.0
92,2000,VIRGINIA,51195,WISE,6412,6504,12916,40123.0
93,2000,VIRGINIA,51197,WYTHE,3462,6539,10001,27599.0
94,2000,VIRGINIA,51199,YORK,8622,15312,23934,56297.0
95,2000,VIRGINIA,51510,ALEXANDRIA,33633,19043,52676,128283.0
96,2000,VIRGINIA,51515,BEDFORD,1078,1269,2347,6299.0
97,2000,VIRGINIA,51520,BRISTOL,2646,3495,6141,17367.0
98,2000,VIRGINIA,51530,BUENA VISTA,941,980,1921,6349.0
99,2000,VIRGINIA,51540,CHARLOTTESVILLE,7762,4034,11796,45049.0
100,2000,VIRGINIA,51550,CHESAPEAKE,33578,39684,73262,199184.0
101,2000,VIRGINIA,51570,COLONIAL HEIGHTS,2100,5519,7619,16897.0
102,2000,VIRGINIA,51580,COVINGTON,1168,966,2134,6303.0
103,2000,VIRGINIA,51590,DANVILLE,8221,9427,17648,48411.0
104,2000,VIRGINIA,51595,EMPORIA,1116,938,2054,5665.0
105,2000,VIRGINIA,51600,FAIRFAX,4361,4762,9123,21498.0
106,2000,VIRGINIA,51610,FALLS CHURCH,3109,2131,5240,10377.0
107,2000,VIRGINIA,51620,FRANKLIN,1763,1393,3156,8346.0
108,2000,VIRGINIA,51630,FREDERICKSBURG,3360,2935,6295,19279.0
109,2000,VIRGINIA,51640,GALAX,996,1160,2156,6837.0
110,2000,VIRGINIA,51650,HAMPTON,27490,19561,47051,146437.0
111,2000,VIRGINIA,51660,HARRISONBURG,3482,5741,9223,40468.0
112,2000,VIRGINIA,51670,HOPEWELL,3024,3749,6773,22354.0
113,2000,VIRGINIA,51678,LEXINGTON,1048,957,2005,6867.0
114,2000,VIRGINIA,51680,LYNCHBURG,10374,12518,22892,65269.0
115,2000,VIRGINIA,51683,MANASSAS,5262,6752,12014,35135.0
116,2000,VIRGINIA,51685,MANASSAS PARK,1048,1460,2508,10290.0
117,2000,VIRGINIA,51690,MARTINSVILLE,3048,2560,5608,15416.0
118,2000,VIRGINIA,51700,NEWPORT NEWS,29779,27006,56785,180150.0
119,2000,VIRGINIA,51710,NORFOLK,38221,21920,60141,234403.0
120,2000,VIRGINIA,51720,NORTON,867,639,1506,3904.0
121,2000,VIRGINIA,51730,PETERSBURG,8751,2109,10860,33740.0
122,2000,VIRGINIA,51735,POQUOSON,1448,4271,5719,11566.0
123,2000,VIRGINIA,51740,PORTSMOUTH,22286,12628,34914,100565.0
124,2000,VIRGINIA,51750,RADFORD,2063,2190,4253,15859.0
125,2000,VIRGINIA,51760,RICHMOND,42717,20265,62982,197790.0
126,2000,VIRGINIA,51770,ROANOKE,17920,14630,32550,94911.0
127,2000,VIRGINIA,51775,SALEM,4348,6188,10536,24747.0
128,2000,VIRGINIA,51790,STAUNTON,3324,4878,8202,23853.0
129,2000,VIRGINIA,51800,SUFFOLK,12471,11836,24307,63677.0
130,2000,VIRGINIA,51810,VIRGINIA BEACH,62268,83674,145942,425257.0
131,2000,VIRGINIA,51820,WAYNESBORO,2737,4084,6821,19520.0
132,2000,VIRGINIA,51830,WILLIAMSBURG,1724,1777,3501,11998.0
133,2000,VIRGINIA,51840,WINCHESTER,3318,4314,7632,23585.0
134,2004,VIRGINIA,51001,ACCOMACK,5518,7726,13244,38305.0
135,2004,VIRGINIA,51003,ALBEMARLE,22088,21189,43277,79236.0
136,2004,VIRGINIA,51005,ALLEGHANY,3203,3962,7165,12926.0
137,2004,VIRGINIA,51007,AMELIA,1862,3499,5361,11400.0
138,2004,VIRGINIA,51009,AMHERST,4866,7758,12624,31894.0
139,2004,VIRGINIA,51011,APPOMATTOX,2191,4366,6557,13705.0
140,2004,VIRGINIA,51013,ARLINGTON,63987,29635,93622,189453.0
141,2004,VIRGINIA,51015,AUGUSTA,7019,22100,29119,65615.0
142,2004,VIRGINIA,51017,BATH,828,1432,2260,5048.0
143,2004,VIRGINIA,51019,BEDFORD,9102,21925,31027,60371.0
144,2004,VIRGINIA,51021,BLAND,846,1962,2808,6871.0
145,2004,VIRGINIA,51023,BOTETOURT,4801,10865,15666,30496.0
146,2004,VIRGINIA,51025,BRUNSWICK,4062,2852,6914,18419.0
147,2004,VIRGINIA,51027,BUCHANAN,5275,4507,9782,26978.0
148,2004,VIRGINIA,51029,BUCKINGHAM,2789,3185,5974,15623.0
149,2004,VIRGINIA,51031,CAMPBELL,6862,15891,22753,51078.0
150,2004,VIRGINIA,51033,CAROLINE,4878,4999,9877,22121.0
151,2004,VIRGINIA,51035,CARROLL,3888,8173,12061,29245.0
152,2004,VIRGINIA,51036,CHARLES CITY,2155,1254,3409,6926.0
153,2004,VIRGINIA,51037,CHARLOTTE,2223,3166,5389,12472.0
154,2004,VIRGINIA,51041,CHESTERFIELD,49346,83745,133091,259903.0
155,2004,VIRGINIA,51043,CLARKE,2699,3741,6440,12652.0
156,2004,VIRGINIA,51045,CRAIG,901,1706,2607,5091.0
157,2004,VIRGINIA,51047,CULPEPER,5476,10026,15502,34262.0
158,2004,VIRGINIA,51049,CUMBERLAND,1721,2377,4098,9017.0
159,2004,VIRGINIA,51051,DICKENSON,3761,3591,7352,16395.0
160,2004,VIRGINIA,51053,DINWIDDIE,4569,6193,10762,24533.0
161,2004,VIRGINIA,51057,ESSEX,2007,2304,4311,9989.0
162,2004,VIRGINIA,51059,FAIRFAX,245671,211980,457651,969749.0
163,2004,VIRGINIA,51061,FAUQUIER,10712,19011,29723,55139.0
164,2004,VIRGINIA,51063,FLOYD,2488,4162,6650,13874.0
165,2004,VIRGINIA,51065,FLUVANNA,4415,6458,10873,20047.0
166,2004,VIRGINIA,51067,FRANKLIN,8002,14048,22050,47286.0
167,2004,VIRGINIA,51069,FREDERICK,8853,19386,28239,59209.0
168,2004,VIRGINIA,51071,GILES,3047,4320,7367,16657.0
169,2004,VIRGINIA,51073,GLOUCESTER,5105,11084,16189,34780.0
170,2004,VIRGINIA,51075,GOOCHLAND,3583,6668,10251,16863.0
171,2004,VIRGINIA,51077,GRAYSON,2430,4655,7085,17917.0
172,2004,VIRGINIA,51079,GREENE,2240,4570,6810,15244.0
173,2004,VIRGINIA,51081,GREENSVILLE,2514,1732,4246,11560.0
174,2004,VIRGINIA,51083,HALIFAX,6220,8363,14583,37355.0
175,2004,VIRGINIA,51085,HANOVER,13941,35404,49345,86320.0
176,2004,VIRGINIA,51087,HENRICO,60864,71809,132673,262300.0
177,2004,VIRGINIA,51089,HENRY,9851,13358,23209,57930.0
178,2004,VIRGINIA,51091,HIGHLAND,522,982,1504,2536.0
179,2004,VIRGINIA,51093,ISLE OF WIGHT,5871,9929,15800,29728.0
180,2004,VIRGINIA,51095,JAMES CITY,11934,18949,30883,48102.0
181,2004,VIRGINIA,51097,KING AND QUEEN,1506,1737,3243,6630.0
182,2004,VIRGINIA,51099,KING GEORGE,2739,5124,7863,16803.0
183,2004,VIRGINIA,51101,KING WILLIAM,2436,4397,6833,13146.0
184,2004,VIRGINIA,51103,LANCASTER,2477,3724,6201,11567.0
185,2004,VIRGINIA,51105,LEE,4005,5664,9669,23589.0
186,2004,VIRGINIA,51107,LOUDOUN,47271,60382,107653,169599.0
187,2004,VIRGINIA,51109,LOUISA,4844,7083,11927,25627.0
188,2004,VIRGINIA,51111,LUNENBURG,2362,2858,5220,13146.0
189,2004,VIRGINIA,51113,MADISON,2176,3556,5732,12520.0
190,2004,VIRGINIA,51115,MATHEWS,1589,3497,5086,9207.0
191,2004,VIRGINIA,51117,MECKLENBURG,5293,7319,12612,32380.0
192,2004,VIRGINIA,51119,MIDDLESEX,1914,3336,5250,9932.0
193,2004,VIRGINIA,51121,MONTGOMERY,14128,17070,31198,83629.0
194,2004,VIRGINIA,51125,NELSON,3543,3539,7082,14445.0
195,2004,VIRGINIA,51127,NEW KENT,2443,5414,7857,13462.0
196,2004,VIRGINIA,51131,NORTHAMPTON,2775,2669,5444,13093.0
197,2004,VIRGINIA,51133,NORTHUMBERLAND,2548,3832,6380,12259.0
198,2004,VIRGINIA,51135,NOTTOWAY,2635,3303,5938,15725.0
199,2004,VIRGINIA,51137,ORANGE,5015,7749,12764,25881.0
200,2004,VIRGINIA,51139,PAGE,3324,6221,9545,23177.0
201,2004,VIRGINIA,51141,PATRICK,2572,5507,8079,19407.0
202,2004,VIRGINIA,51143,PITTSYLVANIA,9274,17673,26947,61745.0
203,2004,VIRGINIA,51145,POWHATAN,3112,8955,12067,22377.0
204,2004,VIRGINIA,51147,PRINCE EDWARD,3632,3571,7203,19720.0
205,2004,VIRGINIA,51149,PRINCE GEORGE,5066,8131,13197,33047.0
206,2004,VIRGINIA,51153,PRINCE WILLIAM,61271,69776,131047,280813.0
207,2004,VIRGINIA,51155,PULASKI,5310,8769,14079,35127.0
208,2004,VIRGINIA,51157,RAPPAHANNOCK,1837,2172,4009,6983.0
209,2004,VIRGINIA,51159,RICHMOND,1243,2082,3325,8809.0
210,2004,VIRGINIA,51161,ROANOKE,16082,30596,46678,85778.0
211,2004,VIRGINIA,51163,ROCKBRIDGE,3627,5412,9039,20808.0
212,2004,VIRGINIA,51165,ROCKINGHAM,7273,21737,29010,67725.0
213,2004,VIRGINIA,51167,RUSSELL,5167,6077,11244,30308.0
214,2004,VIRGINIA,51169,SCOTT,3324,6479,9803,23403.0
215,2004,VIRGINIA,51171,SHENANDOAH,5186,11820,17006,35075.0
216,2004,VIRGINIA,51173,SMYTH,4143,7906,12049,33081.0
217,2004,VIRGINIA,51175,SOUTHAMPTON,3431,4018,7449,17482.0
218,2004,VIRGINIA,51177,SPOTSYLVANIA,16623,28527,45150,90395.0
219,2004,VIRGINIA,51179,STAFFORD,17208,28500,45708,92446.0
220,2004,VIRGINIA,51181,SURRY,1954,1543,3497,6829.0
221,2004,VIRGINIA,51183,SUSSEX,2420,1890,4310,12504.0
222,2004,VIRGINIA,51185,TAZEWELL,7184,10039,17223,44598.0
223,2004,VIRGINIA,51187,WARREN,5241,8600,13841,31584.0
224,2004,VIRGINIA,51191,WASHINGTON,7339,14749,22088,51103.0
225,2004,VIRGINIA,51193,WESTMORELAND,3370,3433,6803,16718.0
226,2004,VIRGINIA,51195,WISE,5802,8330,14132,40123.0
227,2004,VIRGINIA,51197,WYTHE,3581,7911,11492,27599.0
228,2004,VIRGINIA,51199,YORK,10276,19396,29672,56297.0
229,2004,VIRGINIA,51510,ALEXANDRIA,41116,19844,60960,128283.0
230,2004,VIRGINIA,51515,BEDFORD,1042,1472,2514,6299.0
231,2004,VIRGINIA,51520,BRISTOL,2400,4275,6675,17367.0
232,2004,VIRGINIA,51530,BUENA VISTA,936,1417,2353,6349.0
233,2004,VIRGINIA,51540,CHARLOTTESVILLE,11088,4172,15260,45049.0
234,2004,VIRGINIA,51550,CHESAPEAKE,38744,52283,91027,199184.0
235,2004,VIRGINIA,51570,COLONIAL HEIGHTS,2061,6129,8190,16897.0
236,2004,VIRGINIA,51580,COVINGTON,1179,1104,2283,6303.0
237,2004,VIRGINIA,51590,DANVILLE,9436,9399,18835,48411.0
238,2004,VIRGINIA,51595,EMPORIA,1247,970,2217,5665.0
239,2004,VIRGINIA,51600,FAIRFAX,5395,5045,10440,21498.0
240,2004,VIRGINIA,51610,FALLS CHURCH,3944,2074,6018,10377.0
241,2004,VIRGINIA,51620,FRANKLIN,1910,1613,3523,8346.0
242,2004,VIRGINIA,51630,FREDERICKSBURG,4085,3390,7475,19279.0
243,2004,VIRGINIA,51640,GALAX,987,1336,2323,6837.0
244,2004,VIRGINIA,51650,HAMPTON,32016,23399,55415,146437.0
245,2004,VIRGINIA,51660,HARRISONBURG,4726,6165,10891,40468.0
246,2004,VIRGINIA,51670,HOPEWELL,3573,4251,7824,22354.0
247,2004,VIRGINIA,51678,LEXINGTON,1340,982,2322,6867.0
248,2004,VIRGINIA,51680,LYNCHBURG,11727,14400,26127,65269.0
249,2004,VIRGINIA,51683,MANASSAS,5562,7257,12819,35135.0
250,2004,VIRGINIA,51685,MANASSAS PARK,1498,1807,3305,10290.0
251,2004,VIRGINIA,51690,MARTINSVILLE,3036,2538,5574,15416.0
252,2004,VIRGINIA,51700,NEWPORT NEWS,35319,32208,67527,180150.0
253,2004,VIRGINIA,51710,NORFOLK,43518,26401,69919,234403.0
254,2004,VIRGINIA,51720,NORTON,725,768,1493,3904.0
255,2004,VIRGINIA,51730,PETERSBURG,9682,2238,11920,33740.0
256,2004,VIRGINIA,51735,POQUOSON,1424,5004,6428,11566.0
257,2004,VIRGINIA,51740,PORTSMOUTH,24112,15212,39324,100565.0
258,2004,VIRGINIA,51750,RADFORD,2244,2564,4808,15859.0
259,2004,VIRGINIA,51760,RICHMOND,52167,21637,73804,197790.0
260,2004,VIRGINIA,51770,ROANOKE,18862,16661,35523,94911.0
261,2004,VIRGINIA,51775,SALEM,4254,7115,11369,24747.0
262,2004,VIRGINIA,51790,STAUNTON,3756,5805,9561,23853.0
263,2004,VIRGINIA,51800,SUFFOLK,15233,16763,31996,63677.0
264,2004,VIRGINIA,51810,VIRGINIA BEACH,70666,103752,174418,425257.0
265,2004,VIRGINIA,51820,WAYNESBORO,2792,5092,7884,19520.0
266,2004,VIRGINIA,51830,WILLIAMSBURG,2216,2064,4280,11998.0
267,2004,VIRGINIA,51840,WINCHESTER,3967,5283,9250,23585.0
268,2008,VIRGINIA,51001,ACCOMACK,7607,7833,15440,33454.0
269,2008,VIRGINIA,51003,ALBEMARLE,29792,20576,50368,99484.0
270,2008,VIRGINIA,51005,ALLEGHANY,3553,3715,7268,16297.0
271,2008,VIRGINIA,51007,AMELIA,2488,3970,6458,12674.0
272,2008,VIRGINIA,51009,AMHERST,6094,8470,14564,32301.0
273,2008,VIRGINIA,51011,APPOMATTOX,2641,4903,7544,14952.0
274,2008,VIRGINIA,51013,ARLINGTON,78994,29876,108870,209077.0
275,2008,VIRGINIA,51015,AUGUSTA,9825,23120,32945,73662.0
276,2008,VIRGINIA,51017,BATH,1043,1349,2392,4713.0
277,2008,VIRGINIA,51019,BEDFORD,11017,24420,35437,68750.0
278,2008,VIRGINIA,51021,BLAND,864,2031,2895,6827.0
279,2008,VIRGINIA,51023,BOTETOURT,5693,11471,17164,33074.0
280,2008,VIRGINIA,51025,BRUNSWICK,4973,2877,7850,17372.0
281,2008,VIRGINIA,51027,BUCHANAN,4063,4541,8604,24071.0
282,2008,VIRGINIA,51029,BUCKINGHAM,3489,3428,6917,17071.0
283,2008,VIRGINIA,51031,CAMPBELL,8091,17444,25535,54797.0
284,2008,VIRGINIA,51033,CAROLINE,7163,5617,12780,28510.0
285,2008,VIRGINIA,51035,CARROLL,4109,8187,12296,29989.0
286,2008,VIRGINIA,51036,CHARLES CITY,2838,1288,4126,7226.0
287,2008,VIRGINIA,51037,CHARLOTTE,2705,3372,6077,12546.0
288,2008,VIRGINIA,51041,CHESTERFIELD,74310,86413,160723,316895.0
289,2008,VIRGINIA,51043,CLARKE,3457,3840,7297,14143.0
290,2008,VIRGINIA,51045,CRAIG,877,1695,2572,5186.0
291,2008,VIRGINIA,51047,CULPEPER,8802,10711,19513,46894.0
292,2008,VIRGINIA,51049,CUMBERLAND,2255,2418,4673,9951.0
293,2008,VIRGINIA,51051,DICKENSON,3278,3324,6602,15877.0
294,2008,VIRGINIA,51053,DINWIDDIE,6246,6526,12772,27926.0
295,2008,VIRGINIA,51057,ESSEX,2934,2379,5313,11130.0
296,2008,VIRGINIA,51059,FAIRFAX,310359,200994,511353,1083770.0
297,2008,VIRGINIA,51061,FAUQUIER,14616,19227,33843,65495.0
298,2008,VIRGINIA,51063,FLOYD,2937,4441,7378,15268.0
299,2008,VIRGINIA,51065,FLUVANNA,6185,6420,12605,25749.0
300,2008,VIRGINIA,51067,FRANKLIN,9618,15414,25032,56012.0
301,2008,VIRGINIA,51069,FREDERICK,12961,20149,33110,78397.0
302,2008,VIRGINIA,51071,GILES,3192,4462,7654,17149.0
303,2008,VIRGINIA,51073,GLOUCESTER,6916,12089,19005,36821.0
304,2008,VIRGINIA,51075,GOOCHLAND,4813,7643,12456,21496.0
305,2008,VIRGINIA,51077,GRAYSON,2480,4540,7020,15535.0
306,2008,VIRGINIA,51079,GREENE,3174,4980,8154,18453.0
307,2008,VIRGINIA,51081,GREENSVILLE,3122,1729,4851,12127.0
308,2008,VIRGINIA,51083,HALIFAX,8126,8600,16726,36140.0
309,2008,VIRGINIA,51085,HANOVER,18447,37344,55791,99964.0
310,2008,VIRGINIA,51087,HENRICO,86323,67381,153704,307576.0
311,2008,VIRGINIA,51089,HENRY,11118,13758,24876,53971.0
312,2008,VIRGINIA,51091,HIGHLAND,590,930,1520,2317.0
313,2008,VIRGINIA,51093,ISLE OF WIGHT,8573,11258,19831,35240.0
314,2008,VIRGINIA,51095,JAMES CITY,17352,20912,38264,66939.0
315,2008,VIRGINIA,51097,KING AND QUEEN,1918,1763,3681,6968.0
316,2008,VIRGINIA,51099,KING GEORGE,4473,5888,10361,23739.0
317,2008,VIRGINIA,51101,KING WILLIAM,3344,4966,8310,15861.0
318,2008,VIRGINIA,51103,LANCASTER,3235,3647,6882,11371.0
319,2008,VIRGINIA,51105,LEE,3219,5825,9044,25528.0
320,2008,VIRGINIA,51107,LOUDOUN,74845,63336,138181,314980.0
321,2008,VIRGINIA,51109,LOUISA,6978,8182,15160,33083.0
322,2008,VIRGINIA,51111,LUNENBURG,2703,2900,5603,12838.0
323,2008,VIRGINIA,51113,MADISON,2862,3758,6620,13270.0
324,2008,VIRGINIA,51115,MATHEWS,1934,3456,5390,8965.0
325,2008,VIRGINIA,51117,MECKLENBURG,7127,7817,14944,32548.0
326,2008,VIRGINIA,51119,MIDDLESEX,2391,3545,5936,10855.0
327,2008,VIRGINIA,51121,MONTGOMERY,21031,19028,40059,94179.0
328,2008,VIRGINIA,51125,NELSON,4391,3647,8038,15000.0
329,2008,VIRGINIA,51127,NEW KENT,3493,6385,9878,18460.0
330,2008,VIRGINIA,51131,NORTHAMPTON,3800,2713,6513,12408.0
331,2008,VIRGINIA,51133,NORTHUMBERLAND,3312,4041,7353,12389.0
332,2008,VIRGINIA,51135,NOTTOWAY,3413,3499,6912,15875.0
333,2008,VIRGINIA,51137,ORANGE,7107,8506,15613,33625.0
334,2008,VIRGINIA,51139,PAGE,4235,6041,10276,24038.0
335,2008,VIRGINIA,51141,PATRICK,2879,5491,8370,18513.0
336,2008,VIRGINIA,51143,PITTSYLVANIA,11415,18730,30145,63318.0
337,2008,VIRGINIA,51145,POWHATAN,4237,10088,14325,28003.0
338,2008,VIRGINIA,51147,PRINCE EDWARD,5101,4174,9275,23017.0
339,2008,VIRGINIA,51149,PRINCE GEORGE,7130,8752,15882,36013.0
340,2008,VIRGINIA,51153,PRINCE WILLIAM,93435,67621,161056,404011.0
341,2008,VIRGINIA,51155,PULASKI,5918,8857,14775,34869.0
342,2008,VIRGINIA,51157,RAPPAHANNOCK,2105,2227,4332,7440.0
343,2008,VIRGINIA,51159,RICHMOND,1618,2092,3710,9234.0
344,2008,VIRGINIA,51161,ROANOKE,19812,30571,50383,92432.0
345,2008,VIRGINIA,51163,ROCKBRIDGE,4347,5732,10079,22357.0
346,2008,VIRGINIA,51165,ROCKINGHAM,10453,22468,32921,76353.0
347,2008,VIRGINIA,51167,RUSSELL,4932,6389,11321,28773.0
348,2008,VIRGINIA,51169,SCOTT,2725,6980,9705,23061.0
349,2008,VIRGINIA,51171,SHENANDOAH,6912,12005,18917,42076.0
350,2008,VIRGINIA,51173,SMYTH,4239,7817,12056,32103.0
351,2008,VIRGINIA,51175,SOUTHAMPTON,4402,4583,8985,18576.0
352,2008,VIRGINIA,51177,SPOTSYLVANIA,24897,28610,53507,122854.0
353,2008,VIRGINIA,51179,STAFFORD,25716,29221,54937,129446.0
354,2008,VIRGINIA,51181,SURRY,2626,1663,4289,6988.0
355,2008,VIRGINIA,51183,SUSSEX,3301,2026,5327,12095.0
356,2008,VIRGINIA,51185,TAZEWELL,5596,11201,16797,44846.0
357,2008,VIRGINIA,51187,WARREN,6997,8879,15876,37567.0
358,2008,VIRGINIA,51191,WASHINGTON,8063,16077,24140,54691.0
359,2008,VIRGINIA,51193,WESTMORELAND,4577,3719,8296,17468.0
360,2008,VIRGINIA,51195,WISE,4995,8914,13909,41361.0
361,2008,VIRGINIA,51197,WYTHE,4107,8207,12314,29203.0
362,2008,VIRGINIA,51199,YORK,13700,19833,33533,65503.0
363,2008,VIRGINIA,51510,ALEXANDRIA,50473,19181,69654,140337.0
364,2008,VIRGINIA,51515,BEDFORD,1208,1497,2705,6103.0
365,2008,VIRGINIA,51520,BRISTOL,2665,4579,7244,17747.0
366,2008,VIRGINIA,51530,BUENA VISTA,1108,1282,2390,6679.0
367,2008,VIRGINIA,51540,CHARLOTTESVILLE,15705,4078,19783,43223.0
368,2008,VIRGINIA,51550,CHESAPEAKE,53994,52625,106619,223233.0
369,2008,VIRGINIA,51570,COLONIAL HEIGHTS,2562,6161,8723,17426.0
370,2008,VIRGINIA,51580,COVINGTON,1304,1020,2324,5903.0
371,2008,VIRGINIA,51590,DANVILLE,12352,8361,20713,43185.0
372,2008,VIRGINIA,51595,EMPORIA,1702,897,2599,5825.0
373,2008,VIRGINIA,51600,FAIRFAX,6575,4691,11266,22712.0
374,2008,VIRGINIA,51610,FALLS CHURCH,4695,1970,6665,12300.0
375,2008,VIRGINIA,51620,FRANKLIN,2819,1576,4395,8531.0
376,2008,VIRGINIA,51630,FREDERICKSBURG,6155,3413,9568,24932.0
377,2008,VIRGINIA,51640,GALAX,1052,1317,2369,6942.0
378,2008,VIRGINIA,51650,HAMPTON,46917,20476,67393,137471.0
379,2008,VIRGINIA,51660,HARRISONBURG,8444,6048,14492,49043.0
380,2008,VIRGINIA,51670,HOPEWELL,5285,4149,9434,22501.0
381,2008,VIRGINIA,51678,LEXINGTON,1543,914,2457,6990.0
382,2008,VIRGINIA,51680,LYNCHBURG,16269,17638,33907,75657.0
383,2008,VIRGINIA,51683,MANASSAS,7518,5975,13493,37943.0
384,2008,VIRGINIA,51685,MANASSAS PARK,2463,1634,4097,14409.0
385,2008,VIRGINIA,51690,MARTINSVILLE,4139,2311,6450,13854.0
386,2008,VIRGINIA,51700,NEWPORT NEWS,51972,28667,80639,180831.0
387,2008,VIRGINIA,51710,NORFOLK,62819,24814,87633,243056.0
388,2008,VIRGINIA,51720,NORTON,743,744,1487,3971.0
389,2008,VIRGINIA,51730,PETERSBURG,13774,1583,15357,32226.0
390,2008,VIRGINIA,51735,POQUOSON,1748,5229,6977,12110.0
391,2008,VIRGINIA,51740,PORTSMOUTH,32327,13984,46311,95786.0
392,2008,VIRGINIA,51750,RADFORD,2930,2418,5348,16511.0
393,2008,VIRGINIA,51760,RICHMOND,73623,18649,92272,205348.0
394,2008,VIRGINIA,51770,ROANOKE,24934,15394,40328,96742.0
395,2008,VIRGINIA,51775,SALEM,5164,7088,12252,24792.0
396,2008,VIRGINIA,51790,STAUNTON,5569,5330,10899,23906.0
397,2008,VIRGINIA,51800,SUFFOLK,22446,17165,39611,84216.0
398,2008,VIRGINIA,51810,VIRGINIA BEACH,98885,100319,199204,439528.0
399,2008,VIRGINIA,51820,WAYNESBORO,3906,4815,8721,21030.0
400,2008,VIRGINIA,51830,WILLIAMSBURG,4328,2353,6681,14207.0
401,2008,VIRGINIA,51840,WINCHESTER,5268,4725,9993,26330.0
402,2012,VIRGINIA,51001,ACCOMACK,7655,8213,15868,33454.0
403,2012,VIRGINIA,51003,ALBEMARLE,29757,23297,53054,99484.0
404,2012,VIRGINIA,51005,ALLEGHANY,3403,3595,6998,16297.0
405,2012,VIRGINIA,51007,AMELIA,2490,4331,6821,12674.0
406,2012,VIRGINIA,51009,AMHERST,5900,8876,14776,32301.0
407,2012,VIRGINIA,51011,APPOMATTOX,2453,5340,7793,14952.0
408,2012,VIRGINIA,51013,ARLINGTON,81269,34474,115743,209077.0
409,2012,VIRGINIA,51015,AUGUSTA,9451,23624,33075,73662.0
410,2012,VIRGINIA,51017,BATH,894,1274,2168,4713.0
411,2012,VIRGINIA,51019,BEDFORD,10209,26679,36888,68750.0
412,2012,VIRGINIA,51021,BLAND,735,2144,2879,6827.0
413,2012,VIRGINIA,51023,BOTETOURT,5452,12479,17931,33074.0
414,2012,VIRGINIA,51025,BRUNSWICK,4994,2968,7962,17372.0
415,2012,VIRGINIA,51027,BUCHANAN,3094,6436,9530,24071.0
416,2012,VIRGINIA,51029,BUCKINGHAM,3750,3569,7319,17071.0
417,2012,VIRGINIA,51031,CAMPBELL,7595,17695,25290,54797.0
418,2012,VIRGINIA,51033,CAROLINE,7276,6151,13427,28510.0
419,2012,VIRGINIA,51035,CARROLL,3685,8736,12421,29989.0
420,2012,VIRGINIA,51036,CHARLES CITY,2772,1396,4168,7226.0
421,2012,VIRGINIA,51037,CHARLOTTE,2503,3311,5814,12546.0
422,2012,VIRGINIA,51041,CHESTERFIELD,77694,90934,168628,316895.0
423,2012,VIRGINIA,51043,CLARKE,3239,4296,7535,14143.0
424,2012,VIRGINIA,51045,CRAIG,830,1757,2587,5186.0
425,2012,VIRGINIA,51047,CULPEPER,8285,11580,19865,46894.0
426,2012,VIRGINIA,51049,CUMBERLAND,2422,2538,4960,9951.0
427,2012,VIRGINIA,51051,DICKENSON,2473,4274,6747,15877.0
428,2012,VIRGINIA,51053,DINWIDDIE,6550,6875,13425,27926.0
429,2012,VIRGINIA,51057,ESSEX,3016,2602,5618,11130.0
430,2012,VIRGINIA,51059,FAIRFAX,315273,206773,522046,1083770.0
431,2012,VIRGINIA,51061,FAUQUIER,13965,21034,34999,65495.0
432,2012,VIRGINIA,51063,FLOYD,2732,4673,7405,15268.0
433,2012,VIRGINIA,51065,FLUVANNA,5893,6678,12571,25749.0
434,2012,VIRGINIA,51067,FRANKLIN,9090,16718,25808,56012.0
435,2012,VIRGINIA,51069,FREDERICK,12690,22858,35548,78397.0
436,2012,VIRGINIA,51071,GILES,2730,4660,7390,17149.0
437,2012,VIRGINIA,51073,GLOUCESTER,6764,12137,18901,36821.0
438,2012,VIRGINIA,51075,GOOCHLAND,4676,8448,13124,21496.0
439,2012,VIRGINIA,51077,GRAYSON,2068,4801,6869,15535.0
440,2012,VIRGINIA,51079,GREENE,3290,5569,8859,18453.0
441,2012,VIRGINIA,51081,GREENSVILLE,3135,1766,4901,12127.0
442,2012,VIRGINIA,51083,HALIFAX,7766,8694,16460,36140.0
443,2012,VIRGINIA,51085,HANOVER,18294,39940,58234,99964.0
444,2012,VIRGINIA,51087,HENRICO,89594,70449,160043,307576.0
445,2012,VIRGINIA,51089,HENRY,10317,13984,24301,53971.0
446,2012,VIRGINIA,51091,HIGHLAND,459,924,1383,2317.0
447,2012,VIRGINIA,51093,ISLE OF WIGHT,8761,11802,20563,35240.0
448,2012,VIRGINIA,51095,JAMES CITY,17879,22843,40722,66939.0
449,2012,VIRGINIA,51097,KING AND QUEEN,1745,1865,3610,6968.0
450,2012,VIRGINIA,51099,KING GEORGE,4477,6604,11081,23739.0
451,2012,VIRGINIA,51101,KING WILLIAM,3344,5466,8810,15861.0
452,2012,VIRGINIA,51103,LANCASTER,3149,3753,6902,11371.0
453,2012,VIRGINIA,51105,LEE,2583,6847,9430,25528.0
454,2012,VIRGINIA,51107,LOUDOUN,82479,75292,157771,314980.0
455,2012,VIRGINIA,51109,LOUISA,6953,9215,16168,33083.0
456,2012,VIRGINIA,51111,LUNENBURG,2684,2969,5653,12838.0
457,2012,VIRGINIA,51113,MADISON,2639,3869,6508,13270.0
458,2012,VIRGINIA,51115,MATHEWS,1807,3488,5295,8965.0
459,2012,VIRGINIA,51117,MECKLENBURG,6921,7973,14894,32548.0
460,2012,VIRGINIA,51119,MIDDLESEX,2370,3619,5989,10855.0
461,2012,VIRGINIA,51121,MONTGOMERY,19903,20006,39909,94179.0
462,2012,VIRGINIA,51125,NELSON,4171,3947,8118,15000.0
463,2012,VIRGINIA,51127,NEW KENT,3555,7246,10801,18460.0
464,2012,VIRGINIA,51131,NORTHAMPTON,3741,2676,6417,12408.0
465,2012,VIRGINIA,51133,NORTHUMBERLAND,3191,4310,7501,12389.0
466,2012,VIRGINIA,51135,NOTTOWAY,3344,3409,6753,15875.0
467,2012,VIRGINIA,51137,ORANGE,6870,9244,16114,33625.0
468,2012,VIRGINIA,51139,PAGE,3724,6344,10068,24038.0
469,2012,VIRGINIA,51141,PATRICK,2417,5622,8039,18513.0
470,2012,VIRGINIA,51143,PITTSYLVANIA,10858,19263,30121,63318.0
471,2012,VIRGINIA,51145,POWHATAN,4088,11200,15288,28003.0
472,2012,VIRGINIA,51147,PRINCE EDWARD,5132,3952,9084,23017.0
473,2012,VIRGINIA,51149,PRINCE GEORGE,6991,8879,15870,36013.0
474,2012,VIRGINIA,51153,PRINCE WILLIAM,103331,74458,177789,404011.0
475,2012,VIRGINIA,51155,PULASKI,5292,8920,14212,34869.0
476,2012,VIRGINIA,51157,RAPPAHANNOCK,1980,2311,4291,7440.0
477,2012,VIRGINIA,51159,RICHMOND,1574,2160,3734,9234.0
478,2012,VIRGINIA,51161,ROANOKE,18711,31624,50335,92432.0
479,2012,VIRGINIA,51163,ROCKBRIDGE,4088,5898,9986,22357.0
480,2012,VIRGINIA,51165,ROCKINGHAM,10065,24186,34251,76353.0
481,2012,VIRGINIA,51167,RUSSELL,3718,8180,11898,28773.0
482,2012,VIRGINIA,51169,SCOTT,2395,7439,9834,23061.0
483,2012,VIRGINIA,51171,SHENANDOAH,6469,12538,19007,42076.0
484,2012,VIRGINIA,51173,SMYTH,4171,8379,12550,32103.0
485,2012,VIRGINIA,51175,SOUTHAMPTON,4437,4733,9170,18576.0
486,2012,VIRGINIA,51177,SPOTSYLVANIA,25165,31844,57009,122854.0
487,2012,VIRGINIA,51179,STAFFORD,27182,32480,59662,129446.0
488,2012,VIRGINIA,51181,SURRY,2576,1671,4247,6988.0
489,2012,VIRGINIA,51183,SUSSEX,3358,2021,5379,12095.0
490,2012,VIRGINIA,51185,TAZEWELL,3661,13843,17504,44846.0
491,2012,VIRGINIA,51187,WARREN,6452,9869,16321,37567.0
492,2012,VIRGINIA,51191,WASHINGTON,7076,18141,25217,54691.0
493,2012,VIRGINIA,51193,WESTMORELAND,4295,3731,8026,17468.0
494,2012,VIRGINIA,51195,WISE,3760,11076,14836,41361.0
495,2012,VIRGINIA,51197,WYTHE,3783,8324,12107,29203.0
496,2012,VIRGINIA,51199,YORK,13183,20204,33387,65503.0
497,2012,VIRGINIA,51510,ALEXANDRIA,52199,20249,72448,140337.0
498,2012,VIRGINIA,51515,BEDFORD,1225,1527,2752,6103.0
499,2012,VIRGINIA,51520,BRISTOL,2492,4780,7272,17747.0
500,2012,VIRGINIA,51530,BUENA VISTA,919,1564,2483,6679.0
501,2012,VIRGINIA,51540,CHARLOTTESVILLE,16510,4844,21354,43223.0
502,2012,VIRGINIA,51550,CHESAPEAKE,55052,53900,108952,223233.0
503,2012,VIRGINIA,51570,COLONIAL HEIGHTS,2544,5941,8485,17426.0
504,2012,VIRGINIA,51580,COVINGTON,1319,975,2294,5903.0
505,2012,VIRGINIA,51590,DANVILLE,12218,7763,19981,43185.0
506,2012,VIRGINIA,51595,EMPORIA,1793,886,2679,5825.0
507,2012,VIRGINIA,51600,FAIRFAX,6651,4775,11426,22712.0
508,2012,VIRGINIA,51610,FALLS CHURCH,5015,2147,7162,12300.0
509,2012,VIRGINIA,51620,FRANKLIN,2833,1496,4329,8531.0
510,2012,VIRGINIA,51630,FREDERICKSBURG,7131,4060,11191,24932.0
511,2012,VIRGINIA,51640,GALAX,900,1332,2232,6942.0
512,2012,VIRGINIA,51650,HAMPTON,46966,18640,65606,137471.0
513,2012,VIRGINIA,51660,HARRISONBURG,8654,6565,15219,49043.0
514,2012,VIRGINIA,51670,HOPEWELL,5179,3739,8918,22501.0
515,2012,VIRGINIA,51678,LEXINGTON,1486,1146,2632,6990.0
516,2012,VIRGINIA,51680,LYNCHBURG,15948,19806,35754,75657.0
517,2012,VIRGINIA,51683,MANASSAS,8478,6463,14941,37943.0
518,2012,VIRGINIA,51685,MANASSAS PARK,2879,1699,4578,14409.0
519,2012,VIRGINIA,51690,MARTINSVILLE,3855,2312,6167,13854.0
520,2012,VIRGINIA,51700,NEWPORT NEWS,51100,27230,78330,180831.0
521,2012,VIRGINIA,51710,NORFOLK,62687,23147,85834,243056.0
522,2012,VIRGINIA,51720,NORTON,566,895,1461,3971.0
523,2012,VIRGINIA,51730,PETERSBURG,14283,1527,15810,32226.0
524,2012,VIRGINIA,51735,POQUOSON,1679,5312,6991,12110.0
525,2012,VIRGINIA,51740,PORTSMOUTH,32501,12858,45359,95786.0
526,2012,VIRGINIA,51750,RADFORD,2732,2520,5252,16511.0
527,2012,VIRGINIA,51760,RICHMOND,75921,20050,95971,205348.0
528,2012,VIRGINIA,51770,ROANOKE,24134,14991,39125,96742.0
529,2012,VIRGINIA,51775,SALEM,4760,7299,12059,24792.0
530,2012,VIRGINIA,51790,STAUNTON,5728,5272,11000,23906.0
531,2012,VIRGINIA,51800,SUFFOLK,24267,17820,42087,84216.0
532,2012,VIRGINIA,51810,VIRGINIA BEACH,94299,99291,193590,439528.0
533,2012,VIRGINIA,51820,WAYNESBORO,3840,4790,8630,21030.0
534,2012,VIRGINIA,51830,WILLIAMSBURG,4903,2682,7585,14207.0
535,2012,VIRGINIA,51840,WINCHESTER,5094,4946,10040,26330.0
536,2016,VIRGINIA,51001,ACCOMACK,6740,8583,15323,32673.0
537,2016,VIRGINIA,51003,ALBEMARLE,33345,19259,52604,107405.0
538,2016,VIRGINIA,51005,ALLEGHANY,2166,4874,7040,15157.0
539,2016,VIRGINIA,51007,AMELIA,2128,4708,6836,12953.0
540,2016,VIRGINIA,51009,AMHERST,5057,9719,14776,31775.0
541,2016,VIRGINIA,51011,APPOMATTOX,2023,5715,7738,15707.0
542,2016,VIRGINIA,51013,ARLINGTON,92016,20186,112202,233464.0
543,2016,VIRGINIA,51015,AUGUSTA,8177,26163,34340,75079.0
544,2016,VIRGINIA,51017,BATH,603,1548,2151,4307.0
545,2016,VIRGINIA,51019,BEDFORD,9768,30659,40427,78376.0
546,2016,VIRGINIA,51021,BLAND,453,2573,3026,6388.0
547,2016,VIRGINIA,51023,BOTETOURT,4494,13375,17869,33343.0
548,2016,VIRGINIA,51025,BRUNSWICK,4481,3046,7527,16520.0
549,2016,VIRGINIA,51027,BUCHANAN,1721,7296,9017,21788.0
550,2016,VIRGINIA,51029,BUCKINGHAM,3128,3950,7078,17059.0
551,2016,VIRGINIA,51031,CAMPBELL,6664,19551,26215,55225.0
552,2016,VIRGINIA,51033,CAROLINE,6432,7147,13579,30381.0
553,2016,VIRGINIA,51035,CARROLL,2559,10663,13222,29801.0
554,2016,VIRGINIA,51036,CHARLES CITY,2496,1476,3972,7014.0
555,2016,VIRGINIA,51037,CHARLOTTE,2155,3479,5634,12040.0
556,2016,VIRGINIA,51041,CHESTERFIELD,81074,85045,166119,343551.0
557,2016,VIRGINIA,51043,CLARKE,3051,4661,7712,14423.0
558,2016,VIRGINIA,51045,CRAIG,541,2140,2681,5110.0
559,2016,VIRGINIA,51047,CULPEPER,7759,13349,21108,51101.0
560,2016,VIRGINIA,51049,CUMBERLAND,2036,2697,4733,9824.0
561,2016,VIRGINIA,51051,DICKENSON,1335,4932,6267,14756.0
562,2016,VIRGINIA,51053,DINWIDDIE,5765,7447,13212,28485.0
563,2016,VIRGINIA,51057,ESSEX,2542,2657,5199,10998.0
564,2016,VIRGINIA,51059,FAIRFAX,355133,157710,512843,1145862.0
565,2016,VIRGINIA,51061,FAUQUIER,12971,22127,35098,69728.0
566,2016,VIRGINIA,51063,FLOYD,2300,5293,7593,15704.0
567,2016,VIRGINIA,51065,FLUVANNA,5760,7025,12785,26594.0
568,2016,VIRGINIA,51067,FRANKLIN,7257,18569,25826,56187.0
569,2016,VIRGINIA,51069,FREDERICK,11932,26083,38015,86415.0
570,2016,VIRGINIA,51071,GILES,1950,5910,7860,16772.0
571,2016,VIRGINIA,51073,GLOUCESTER,5404,13096,18500,37222.0
572,2016,VIRGINIA,51075,GOOCHLAND,4889,8384,13273,22865.0
573,2016,VIRGINIA,51077,GRAYSON,1407,5592,6999,15742.0
574,2016,VIRGINIA,51079,GREENE,2924,5945,8869,19519.0
575,2016,VIRGINIA,51081,GREENSVILLE,2558,1737,4295,11525.0
576,2016,VIRGINIA,51083,HALIFAX,6897,9704,16601,34552.0
577,2016,VIRGINIA,51085,HANOVER,19382,39630,59012,105537.0
578,2016,VIRGINIA,51087,HENRICO,93935,59857,153792,327535.0
579,2016,VIRGINIA,51089,HENRY,8198,15208,23406,51308.0
580,2016,VIRGINIA,51091,HIGHLAND,371,958,1329,2204.0
581,2016,VIRGINIA,51093,ISLE OF WIGHT,7881,12204,20085,36627.0
582,2016,VIRGINIA,51095,JAMES CITY,19105,21306,40411,74916.0
583,2016,VIRGINIA,51097,KING AND QUEEN,1468,2099,3567,7042.0
584,2016,VIRGINIA,51099,KING GEORGE,4007,7341,11348,26229.0
585,2016,VIRGINIA,51101,KING WILLIAM,2760,5975,8735,16688.0
586,2016,VIRGINIA,51103,LANCASTER,2869,3523,6392,10724.0
587,2016,VIRGINIA,51105,LEE,1627,7543,9170,23948.0
588,2016,VIRGINIA,51107,LOUDOUN,100795,69949,170744,395134.0
589,2016,VIRGINIA,51109,LOUISA,6212,10528,16740,36040.0
590,2016,VIRGINIA,51111,LUNENBURG,2227,3204,5431,12282.0
591,2016,VIRGINIA,51113,MADISON,2203,4419,6622,13170.0
592,2016,VIRGINIA,51115,MATHEWS,1563,3517,5080,8788.0
593,2016,VIRGINIA,51117,MECKLENBURG,6285,8288,14573,30728.0
594,2016,VIRGINIA,51119,MIDDLESEX,2108,3670,5778,10675.0
595,2016,VIRGINIA,51121,MONTGOMERY,20021,19459,39480,98140.0
596,2016,VIRGINIA,51125,NELSON,3689,4154,7843,14831.0
597,2016,VIRGINIA,51127,NEW KENT,3546,8118,11664,21686.0
598,2016,VIRGINIA,51131,NORTHAMPTON,3255,2686,5941,11885.0
599,2016,VIRGINIA,51133,NORTHUMBERLAND,2852,4302,7154,12190.0
600,2016,VIRGINIA,51135,NOTTOWAY,2829,3712,6541,15433.0
601,2016,VIRGINIA,51137,ORANGE,5957,10521,16478,36010.0
602,2016,VIRGINIA,51139,PAGE,2514,7831,10345,23788.0
603,2016,VIRGINIA,51141,PATRICK,1768,6454,8222,17748.0
604,2016,VIRGINIA,51143,PITTSYLVANIA,9199,21554,30753,61256.0
605,2016,VIRGINIA,51145,POWHATAN,4060,11885,15945,28815.0
606,2016,VIRGINIA,51147,PRINCE EDWARD,4591,4101,8692,22905.0
607,2016,VIRGINIA,51149,PRINCE GEORGE,6419,9157,15576,38114.0
608,2016,VIRGINIA,51153,PRINCE WILLIAM,113144,71721,184865,461423.0
609,2016,VIRGINIA,51155,PULASKI,4172,10322,14494,34182.0
610,2016,VIRGINIA,51157,RAPPAHANNOCK,1747,2539,4286,7378.0
611,2016,VIRGINIA,51159,RICHMOND,1347,2213,3560,8884.0
612,2016,VIRGINIA,51161,ROANOKE,17200,31408,48608,93823.0
613,2016,VIRGINIA,51163,ROCKBRIDGE,3508,6680,10188,22570.0
614,2016,VIRGINIA,51165,ROCKINGHAM,9366,25990,35356,80284.0
615,2016,VIRGINIA,51167,RUSSELL,2330,9521,11851,27141.0
616,2016,VIRGINIA,51169,SCOTT,1581,8247,9828,21902.0
617,2016,VIRGINIA,51171,SHENANDOAH,5273,14094,19367,43224.0
618,2016,VIRGINIA,51173,SMYTH,2665,9750,12415,30767.0
619,2016,VIRGINIA,51175,SOUTHAMPTON,3595,5035,8630,17880.0
620,2016,VIRGINIA,51177,SPOTSYLVANIA,24207,34623,58830,132833.0
621,2016,VIRGINIA,51179,STAFFORD,27908,33868,61776,146773.0
622,2016,VIRGINIA,51181,SURRY,2272,1819,4091,6523.0
623,2016,VIRGINIA,51183,SUSSEX,2879,2055,4934,11377.0
624,2016,VIRGINIA,51185,TAZEWELL,2895,15168,18063,41603.0
625,2016,VIRGINIA,51187,WARREN,5169,11773,16942,39492.0
626,2016,VIRGINIA,51191,WASHINGTON,5553,19320,24873,54071.0
627,2016,VIRGINIA,51193,WESTMORELAND,3836,4448,8284,17751.0
628,2016,VIRGINIA,51195,WISE,2701,12086,14787,38486.0
629,2016,VIRGINIA,51197,WYTHE,2770,10046,12816,28844.0
630,2016,VIRGINIA,51199,YORK,12999,18837,31836,67982.0
631,2016,VIRGINIA,51510,ALEXANDRIA,57242,13285,70527,157613.0
632,2016,VIRGINIA,51515,BEDFORD,0,0,0,
633,2016,VIRGINIA,51520,BRISTOL,1835,4892,6727,16912.0
634,2016,VIRGINIA,51530,BUENA VISTA,693,1430,2123,6484.0
635,2016,VIRGINIA,51540,CHARLOTTESVILLE,17901,2960,20861,47096.0
636,2016,VIRGINIA,51550,CHESAPEAKE,52627,54047,106674,239982.0
637,2016,VIRGINIA,51570,COLONIAL HEIGHTS,2367,5681,8048,17428.0
638,2016,VIRGINIA,51580,COVINGTON,914,1349,2263,5598.0
639,2016,VIRGINIA,51590,DANVILLE,11059,7303,18362,41070.0
640,2016,VIRGINIA,51595,EMPORIA,1530,789,2319,5442.0
641,2016,VIRGINIA,51600,FAIRFAX,7367,3702,11069,23531.0
642,2016,VIRGINIA,51610,FALLS CHURCH,5819,1324,7143,14128.0
643,2016,VIRGINIA,51620,FRANKLIN,2519,1421,3940,8147.0
644,2016,VIRGINIA,51630,FREDERICKSBURG,6707,3744,10451,28622.0
645,2016,VIRGINIA,51640,GALAX,681,1603,2284,6517.0
646,2016,VIRGINIA,51650,HAMPTON,41312,17902,59214,135041.0
647,2016,VIRGINIA,51660,HARRISONBURG,10212,6262,16474,53273.0
648,2016,VIRGINIA,51670,HOPEWELL,4724,3885,8609,22456.0
649,2016,VIRGINIA,51678,LEXINGTON,1514,766,2280,7241.0
650,2016,VIRGINIA,51680,LYNCHBURG,14792,17982,32774,80569.0
651,2016,VIRGINIA,51683,MANASSAS,8423,5953,14376,41174.0
652,2016,VIRGINIA,51685,MANASSAS PARK,3204,1733,4937,16986.0
653,2016,VIRGINIA,51690,MARTINSVILLE,3533,2149,5682,12852.0
654,2016,VIRGINIA,51700,NEWPORT NEWS,45618,25468,71086,179673.0
655,2016,VIRGINIA,51710,NORFOLK,57023,21552,78575,244601.0
656,2016,VIRGINIA,51720,NORTON,383,1021,1404,3970.0
657,2016,VIRGINIA,51730,PETERSBURG,12021,1451,13472,31362.0
658,2016,VIRGINIA,51735,POQUOSON,1601,5092,6693,12090.0
659,2016,VIRGINIA,51740,PORTSMOUTH,28497,12795,41292,95097.0
660,2016,VIRGINIA,51750,RADFORD,2925,2638,5563,17691.0
661,2016,VIRGINIA,51760,RICHMOND,81259,15581,96840,226622.0
662,2016,VIRGINIA,51770,ROANOKE,22286,14789,37075,99229.0
663,2016,VIRGINIA,51775,SALEM,4202,7226,11428,25317.0
664,2016,VIRGINIA,51790,STAUNTON,5333,5133,10466,24432.0
665,2016,VIRGINIA,51800,SUFFOLK,23280,18006,41286,90093.0
666,2016,VIRGINIA,51810,VIRGINIA BEACH,91032,98224,189256,450201.0
667,2016,VIRGINIA,51820,WAYNESBORO,3764,4801,8565,22140.0
668,2016,VIRGINIA,51830,WILLIAMSBURG,5206,1925,7131,14927.0
669,2016,VIRGINIA,51840,WINCHESTER,5164,4790,9954,27897.0
670,2020,VIRGINIA,51001,ACCOMACK,7578,9172,16750,32673.0
671,2020,VIRGINIA,51003,ALBEMARLE,42466,20804,63270,107405.0
672,2020,VIRGINIA,51005,ALLEGHANY,2243,5859,8102,15157.0
673,2020,VIRGINIA,51007,AMELIA,2411,5390,7801,12953.0
674,2020,VIRGINIA,51009,AMHERST,5672,11041,16713,31775.0
675,2020,VIRGINIA,51011,APPOMATTOX,2418,6702,9120,15707.0
676,2020,VIRGINIA,51013,ARLINGTON,105344,22318,127662,233464.0
677,2020,VIRGINIA,51015,AUGUSTA,10840,30714,41554,75079.0
678,2020,VIRGINIA,51017,BATH,646,1834,2480,4307.0
679,2020,VIRGINIA,51019,BEDFORD,12176,35600,47776,78376.0
680,2020,VIRGINIA,51021,BLAND,532,2903,3435,6388.0
681,2020,VIRGINIA,51023,BOTETOURT,5700,15099,20799,33343.0
682,2020,VIRGINIA,51025,BRUNSWICK,4552,3357,7909,16520.0
683,2020,VIRGINIA,51027,BUCHANAN,1587,8311,9898,21788.0
684,2020,VIRGINIA,51029,BUCKINGHAM,3471,4544,8015,17059.0
685,2020,VIRGINIA,51031,CAMPBELL,8070,21245,29315,55225.0
686,2020,VIRGINIA,51033,CAROLINE,7657,8336,15993,30381.0
687,2020,VIRGINIA,51035,CARROLL,2842,12659,15501,29801.0
688,2020,VIRGINIA,51036,CHARLES CITY,2624,1761,4385,7014.0
689,2020,VIRGINIA,51037,CHARLOTTE,2317,3815,6132,12040.0
690,2020,VIRGINIA,51041,CHESTERFIELD,106935,93326,200261,343551.0
691,2020,VIRGINIA,51043,CLARKE,3920,5192,9112,14423.0
692,2020,VIRGINIA,51045,CRAIG,587,2536,3123,5110.0
693,2020,VIRGINIA,51047,CULPEPER,10617,16012,26629,51101.0
694,2020,VIRGINIA,51049,CUMBERLAND,2227,3019,5246,9824.0
695,2020,VIRGINIA,51051,DICKENSON,1503,5748,7251,14756.0
696,2020,VIRGINIA,51053,DINWIDDIE,6224,8695,14919,28485.0
697,2020,VIRGINIA,51057,ESSEX,3038,3075,6113,10998.0
698,2020,VIRGINIA,51059,FAIRFAX,419943,168401,588344,1145862.0
699,2020,VIRGINIA,51061,FAUQUIER,17565,25106,42671,69728.0
700,2020,VIRGINIA,51063,FLOYD,3004,6225,9229,15704.0
701,2020,VIRGINIA,51065,FLUVANNA,7414,8155,15569,26594.0
702,2020,VIRGINIA,51067,FRANKLIN,8381,20895,29276,56187.0
703,2020,VIRGINIA,51069,FREDERICK,17207,30558,47765,86415.0
704,2020,VIRGINIA,51071,GILES,2156,6876,9032,16772.0
705,2020,VIRGINIA,51073,GLOUCESTER,6964,14875,21839,37222.0
706,2020,VIRGINIA,51075,GOOCHLAND,6685,9966,16651,22865.0
707,2020,VIRGINIA,51077,GRAYSON,1535,6529,8064,15742.0
708,2020,VIRGINIA,51079,GREENE,4163,6866,11029,19519.0
709,2020,VIRGINIA,51081,GREENSVILLE,2627,1914,4541,11525.0
710,2020,VIRGINIA,51083,HALIFAX,7666,10418,18084,34552.0
711,2020,VIRGINIA,51085,HANOVER,25307,44318,69625,105537.0
712,2020,VIRGINIA,51087,HENRICO,116572,63440,180012,327535.0
713,2020,VIRGINIA,51089,HENRY,9127,16725,25852,51308.0
714,2020,VIRGINIA,51091,HIGHLAND,417,1092,1509,2204.0
715,2020,VIRGINIA,51093,ISLE OF WIGHT,9399,13707,23106,36627.0
716,2020,VIRGINIA,51095,JAMES CITY,25553,23153,48706,74916.0
717,2020,VIRGINIA,51097,KING AND QUEEN,1590,2450,4040,7042.0
718,2020,VIRGINIA,51099,KING GEORGE,5404,8446,13850,26229.0
719,2020,VIRGINIA,51101,KING WILLIAM,3260,7320,10580,16688.0
720,2020,VIRGINIA,51103,LANCASTER,3368,3697,7065,10724.0
721,2020,VIRGINIA,51105,LEE,1489,8365,9854,23948.0
722,2020,VIRGINIA,51107,LOUDOUN,138372,82088,220460,395134.0
723,2020,VIRGINIA,51109,LOUISA,8269,13294,21563,36040.0
724,2020,VIRGINIA,51111,LUNENBURG,2418,3537,5955,12282.0
725,2020,VIRGINIA,51113,MADISON,2698,5300,7998,13170.0
726,2020,VIRGINIA,51115,MATHEWS,1825,3901,5726,8788.0
727,2020,VIRGINIA,51117,MECKLENBURG,6803,9266,16069,30728.0
728,2020,VIRGINIA,51119,MIDDLESEX,2491,4196,6687,10675.0
729,2020,VIRGINIA,51121,MONTGOMERY,23218,20629,43847,98140.0
730,2020,VIRGINIA,51125,NELSON,4327,4812,9139,14831.0
731,2020,VIRGINIA,51127,NEW KENT,4621,9631,14252,21686.0
732,2020,VIRGINIA,51131,NORTHAMPTON,3667,2955,6622,11885.0
733,2020,VIRGINIA,51133,NORTHUMBERLAND,3252,4485,7737,12190.0
734,2020,VIRGINIA,51135,NOTTOWAY,2971,4027,6998,15433.0
735,2020,VIRGINIA,51137,ORANGE,7995,12426,20421,36010.0
736,2020,VIRGINIA,51139,PAGE,3007,9345,12352,23788.0
737,2020,VIRGINIA,51141,PATRICK,1954,7485,9439,17748.0
738,2020,VIRGINIA,51143,PITTSYLVANIA,10115,23751,33866,61256.0
739,2020,VIRGINIA,51145,POWHATAN,5320,14055,19375,28815.0
740,2020,VIRGINIA,51147,PRINCE EDWARD,4973,4434,9407,22905.0
741,2020,VIRGINIA,51149,PRINCE GEORGE,7103,10103,17206,38114.0
742,2020,VIRGINIA,51153,PRINCE WILLIAM,142863,81222,224085,461423.0
743,2020,VIRGINIA,51155,PULASKI,4925,12127,17052,34182.0
744,2020,VIRGINIA,51157,RAPPAHANNOCK,2096,2812,4908,7378.0
745,2020,VIRGINIA,51159,RICHMOND,1513,2547,4060,8884.0
746,2020,VIRGINIA,51161,ROANOKE,21801,34268,56069,93823.0
747,2020,VIRGINIA,51163,ROCKBRIDGE,4086,8088,12174,22570.0
748,2020,VIRGINIA,51165,ROCKINGHAM,12644,30349,42993,80284.0
749,2020,VIRGINIA,51167,RUSSELL,2373,10879,13252,27141.0
750,2020,VIRGINIA,51169,SCOTT,1692,9063,10755,21902.0
751,2020,VIRGINIA,51171,SHENANDOAH,6836,16463,23299,43224.0
752,2020,VIRGINIA,51173,SMYTH,3008,10963,13971,30767.0
753,2020,VIRGINIA,51175,SOUTHAMPTON,3969,5730,9699,17880.0
754,2020,VIRGINIA,51177,SPOTSYLVANIA,34307,39411,73718,132833.0
755,2020,VIRGINIA,51179,STAFFORD,40245,37636,77881,146773.0
756,2020,VIRGINIA,51181,SURRY,2397,2025,4422,6523.0
757,2020,VIRGINIA,51183,SUSSEX,2827,2219,5046,11377.0
758,2020,VIRGINIA,51185,TAZEWELL,3205,16731,19936,41603.0
759,2020,VIRGINIA,51187,WARREN,6603,14069,20672,39492.0
760,2020,VIRGINIA,51191,WASHINGTON,6617,21679,28296,54071.0
761,2020,VIRGINIA,51193,WESTMORELAND,4501,5318,9819,17751.0
762,2020,VIRGINIA,51195,WISE,3110,13366,16476,38486.0
763,2020,VIRGINIA,51197,WYTHE,3143,11733,14876,28844.0
764,2020,VIRGINIA,51199,YORK,17683,20241,37924,67982.0
765,2020,VIRGINIA,51510,ALEXANDRIA CITY,66240,14544,80784,157613.0
766,2020,VIRGINIA,51520,BRISTOL CITY,2313,5347,7660,16912.0
767,2020,VIRGINIA,51530,BUENA VISTA CITY,825,1863,2688,6484.0
768,2020,VIRGINIA,51540,CHARLOTTESVILLE CITY,20696,3094,23790,47096.0
769,2020,VIRGINIA,51550,CHESAPEAKE CITY,66377,58180,124557,239982.0
770,2020,VIRGINIA,51570,COLONIAL HEIGHTS CITY,2972,6007,8979,17428.0
771,2020,VIRGINIA,51580,COVINGTON CITY,964,1580,2544,5598.0
772,2020,VIRGINIA,51590,DANVILLE CITY,11710,7428,19138,41070.0
773,2020,VIRGINIA,51595,EMPORIA CITY,1612,754,2366,5442.0
774,2020,VIRGINIA,51600,FAIRFAX CITY,9174,4007,13181,23531.0
775,2020,VIRGINIA,51610,FALLS CHURCH CITY,7146,1490,8636,14128.0
776,2020,VIRGINIA,51620,FRANKLIN CITY,2525,1487,4012,8147.0
777,2020,VIRGINIA,51630,FREDERICKSBURG CITY,8517,4037,12554,28622.0
778,2020,VIRGINIA,51640,GALAX CITY,777,1838,2615,6517.0
779,2020,VIRGINIA,51650,HAMPTON CITY,46220,18430,64650,135041.0
780,2020,VIRGINIA,51660,HARRISONBURG CITY,11022,5591,16613,53273.0
781,2020,VIRGINIA,51670,HOPEWELL CITY,5430,4020,9450,22456.0
782,2020,VIRGINIA,51678,LEXINGTON CITY,1791,906,2697,7241.0
783,2020,VIRGINIA,51680,LYNCHBURG CITY,18048,17097,35145,80569.0
784,2020,VIRGINIA,51683,MANASSAS CITY,10356,6256,16612,41174.0
785,2020,VIRGINIA,51685,MANASSAS PARK CITY,3992,1979,5971,16986.0
786,2020,VIRGINIA,51690,MARTINSVILLE CITY,3766,2165,5931,12852.0
787,2020,VIRGINIA,51700,NEWPORT NEWS CITY,53099,26377,79476,179673.0
788,2020,VIRGINIA,51710,NORFOLK CITY,64440,23443,87883,244601.0
789,2020,VIRGINIA,51720,NORTON CITY,464,1109,1573,3970.0
790,2020,VIRGINIA,51730,PETERSBURG CITY,12389,1584,13973,31362.0
791,2020,VIRGINIA,51735,POQUOSON CITY,2054,5605,7659,12090.0
792,2020,VIRGINIA,51740,PORTSMOUTH CITY,30948,12755,43703,95097.0
793,2020,VIRGINIA,51750,RADFORD CITY,3358,2786,6144,17691.0
794,2020,VIRGINIA,51760,RICHMOND CITY,92175,16603,108778,226622.0
795,2020,VIRGINIA,51770,ROANOKE CITY,26773,15607,42380,99229.0
796,2020,VIRGINIA,51775,SALEM CITY,5148,7683,12831,25317.0
797,2020,VIRGINIA,51790,STAUNTON CITY,6981,5695,12676,24432.0
798,2020,VIRGINIA,51800,SUFFOLK CITY,28676,20082,48758,90093.0
799,2020,VIRGINIA,51810,VIRGINIA BEACH CITY,117393,105087,222480,450201.0
800,2020,VIRGINIA,51820,WAYNESBORO CITY,4961,5507,10468,22140.0
801,2020,VIRGINIA,51830,WILLIAMSBURG CITY,4790,1963,6753,14927.0
802,2020,VIRGINIA,51840,WINCHESTER CITY,6610,5221,11831,27897.0
